Deutsch	Wissenschaftlich
Alle Taxa	Alle Taxa
Flechten	Lichenes
Isländisch Moos	Cetraria islandica
Rentierflechte	Cladonia rangiferina
Moose	Bryophyta
Farnpflanzen	Pteridophyta
Bärlappähnliche	Lycopodiatae
Bärlappgewächse	Lycopodiaceae
Wald-Bärlapp	Lycopodium annotinum
Tannenbärlapp	Huperzia selago
Moosfarngewächse	Selaginellaceae
Dorniger Moosfarn	Selaginella selaginoides
Schachtelhalmgewächse	Equisetaceae
Acker-Schachtelhalm	Equisetum arvense
Überwinternder Schachtelhalm	Equisetum hyemale
Wald-Schachtelhalm	Equisetum sylvaticum
Echte Farne	Filicatae
Eusporangiate Farne	Ophioglossidae
Natterzungengewächse	Ophioglossaceae
Gewöhnliche Mondraute	Botrychium lunaria
Leptosporangiate Farne	Pterididae
Streifenfarn	Asplenium
Mauerraute	Asplenium ruta-muraria
Braunstieliger Streifenfarn	Asplenium trichomanes
Grünstieliger Streifenfarn	Asplenium viride
Hirschzunge	Phyllitis scolopendrium
Gewöhnlicher Waldfarn	Athyrium filix-femina
Gewöhnlicher Wurmfarn	Dryopteris filix-mas
Samenpflanzen	Spermatophyta
Nacktsamer	Gymnospermae
Ginkgo-Gewächse	Ginkgoaceae
Ginkgo	Ginkgo biloba
Föhrengewächse	Pinaceae
Tanne	Abies alba
Lärche	Larix decidua
Fichte	Picea abies
Föhre	Pinus
Arve	Pinus cembra
Bergföhre	Pinus mugo
Waldföhre	Pinus sylvestris
Zypressengewächse	Cupressaceae
Wacholder	Juniperus
Gewöhnlicher Wacholder	Juniperus communis
Zwerg-Wacholder	Juniperus nana
Sadebaum	Juniperus sabina
Eibengewächse	Taxaceae
Eibe	Taxus baccata
Bedecktsamer	Angiospermae
Zweikeimblättrige	Dicotyledoneae
Sauerdorngewächse	Berberidaceae
Gewöhnliche Berberitze	Berberis vulgaris
Hahnenfussgewächse	Ranunculaceae
Eisenhut	Aconitum
Gewöhnliche Akelei	Aquilegia vulgaris
Europäische Trollblume	Trollius europaeus
Hahnenfuss	Ranunculus
Knolliger Hahnenfuss	Ranunculus bulbosus
Scharbockskraut	Ranunculus ficaria
Fries Hahnenfuss	Ranunculus friesianus
Berg-Hahnenfuss	Ranunculus montanus
Kriechender Hahnenfuss	Ranunculus repens
Eisenhutblättriger Hahnenfuss	Ranunculus aconitifolius
Alpen-Hahnenfuss	Ranunculus alpestris
Busch-Windröschen	Anemone nemorosa
Sumpf-Dotterblume	Caltha palustris
Gewöhnliche Waldrebe	Clematis vitalba
Küchenschelle	Pulsatilla
Alpen-Anemone	Pulsatilla alpina
Schwefel-Anemone	Pulsatilla apiifolia
Frühlings-Anemone	Pulsatilla vernalis
Papaveraceae	Papaveraceae
Chelidonium majus	Chelidonium majus
Papaver rhoeas	Papaver rhoeas
Nelkengewächse	Caryophyllaceae
Leimkrautartige	Silenoideae
Leimkraut	Silene
Stengelloses Leimkraut	Silene acaulis
Rote Waldnelke	Silene dioica
Nickendes Leimkraut	Silene nutans
Felsen-Leimkraut	Silene rupestris
Gewöhnliches Leimkraut	Silene vulgaris
Nelke	Dianthus
Kartäuser-Nelke	Dianthus carthusianorum
Stein-Nelke	Dianthus sylvestris
Kriechendes Gipskraut	Gypsophila repens
Rotes Seifenkraut	Saponaria ocymoides
Mierenartige	Alsinoideae
Hornkraut	Cerastium
Gewöhnliches Hornkraut	Cerastium holosteoides
Sternmiere	Stellaria
Vogelmiere	Stellaria media
Gänsefussgewächse	Chenopodiaceae
Gänsefuss	Chenopodium
Weisser Gänsefuss	Chenopodium album
Guter Heinrich	Chenopodium bonus-henricus
Knöterichgewächse	Polygonaceae
Ampfer	Rumex
Wiesen-Sauerampfer	Rumex acetosa
Alpen-Ampfer	Rumex alpinus
Stumpfblättriger Ampfer	Rumex obtusifolius
Schildblättriger Ampfer	Rumex scutatus
Knöterich	Polygonum
Schlangen-Knöterich	Polygonum bistorta
Knöllchen-Knöterich	Polygonum viviparum
Nesselartige	Urticales
Hanfgewächse	Cannabaceae
Hopfen	Humulus lupulus
Ulmengewächse	Ulmaceae
Berg-Ulme	Ulmus glabra
Nesselgewächse	Urticaceae
Grosse Brennessel	Urtica dioica
Dickblattgewächse	Crassulaceae
Mauerpfeffer	Sedum
Hauswurz	Sempervivum
Steinbrechgewächse	Saxifragaceae
Mauerpfeffer-Steinbrech	Saxifraga aizoides
Immergrüner Steinbrech	Saxifraga paniculata
Mannsschild-Steinbrech	Saxifraga androsacea
Gegenblättriger Steinbrech	Saxifraga oppositifolia
Rundblätriger Steinbrech	Saxifraga rotundifolia
Sternblütiger Steinbrech	Saxifraga stellaris
Rosengewächse	Rosaceae
Silberwurz	Dryas octopetala
Nelkenwurz	Geum
Berg-Nelkenwurz	Geum montanum
Bach-Nelkenwurz	Geum rivale
Gewöhnliche Nelkenwurz	Geum urbanum
Spierstaude	Filipendula ulmaria
Fingerkraut	Potentilla
Gänse-Fingerkraut	Potentilla anserina
Gold-Fingerkraut	Potentilla aurea
Aufrechtes Fingerkraut	Potentilla erecta
Kriechendes Fingerkraut	Potentilla reptans
Frauenmäntel	Alchemilla
Silbermantel	Alchemilla conjuncta
Frauenmantel	Alchemilla vulgaris
Kleiner Wiesenknopf	Sanguisorba minor
Kirsche	Prunus
Traubenkirsche	Prunus padus
Schwarzdorn	Prunus spinosa
Crataegus	Crataegus
Eberesche	Sorbus
Mehlbeerbaum	Sorbus aria
Vogelbeerbaum	Sorbus aucuparia
Erdbeere	Fragaria
Wald-Erdbeere	Fragaria vesca
Rose	Rosa
Hunds-Rose	Rosa canina
Brombeeren	Rubus
Hülsenfrüchtler	Fabales
Schmetterlingsblütler	Fabaceae
Schneckenklee	Medicago
Hopfenklee	Medicago lupulina
Klee	Trifolium
Alpen-Klee	Trifolium alpinum
Braun-Klee	Trifolium badium
Berg-Klee	Trifolium montanum
Rot-Klee	Trifolium pratense
Weiss-Klee	Trifolium repens
Lotus	Lotus
Gewöhnlicher Hornklee	Lotus corniculatus
Platterbse	Lathyrus
Wiesen-Platterbse	Lathyrus pratensis
Wicke	Vicia
Vogel-Wicke	Vicia cracca
Futter-Wicke	Vicia sativa
Zaun-Wicke	Vicia sepium
Gewöhnlicher Wundklee	Anthyllis vulneraria
Tragant	Astragalus
Alpen-Tragant	Astragalus alpinus
Hufeisenklee	Hippocrepis comosa
Saat-Esparsette	Onobrychis viciifolia
Spitzkiel	Oxytropis
Feld-Spitzkiel	Oxytropis campestris
Nachtkerzengewächse	Onagraceae
Weidenröschen	Epilobium
Aceraceae	Aceraceae
Acer	Acer
Acer campestre	Acer campestre
Acer platanoides	Acer platanoides
Acer pseudoplatanus	Acer pseudoplatanus
Storchschnabelgewächse	Geraniaceae
Gewöhnlicher Reiherschnabel	Erodium cicutarium
Storchschnabel	Geranium
Pyrenäen-Storchschnabel	Geranium pyrenaicum
Ruprechtskraut	Geranium robertianum
Blutroter Storchschnabel	Geranium sanguineum
Wald-Storchschnabel	Geranium sylvaticum
Leingewächse	Linaceae
Purgier-Lein	Linum catharticum
Sauerkleegewächse	Oxalidaceae
Gewöhnlicher Sauerklee	Oxalis acetosella
Kreuzblumengewächse	Polygalaceae
Buchsblättrige Kreuzblume	Polygala chamaebuxus
Gewöhnliche Kreuzblume	Polygala vulgaris
Spindelstrauchgewächse	Celastraceae
Pfaffenhütchen	Euonymus europaea
Kreuzdorngewächse	Rhamnaceae
Faulbaum	Frangula alnus
Gewöhnlicher Kreuzdorn	Rhamnus cathartica
Mistelgewächse	Loranthaceae
Mistel	Viscum album
Wolfsmilchgewächse	Euphorbiaceae
Wolfsmilch	Euphorbia
Mandelblättrige Wolfsmilch	Euphorbia amygdaloides
Zypressen-Wolfsmilch	Euphorbia cyparissias
Ausdauerndes Bingelkraut	Mercurialis perennis
Ölweidengewächse	Elaeagnaceae
Sanddorn	Hippophaë rhamnoides
Araliales	Araliales
Araliaceae	Araliaceae
Hedera helix	Hedera helix
Apiaceae	Apiaceae
Aegopodium podagraria	Aegopodium podagraria
Carum carvi	Carum carvi
Anthriscus sylvestris	Anthriscus sylvestris
Heracleum sphondylium	Heracleum sphondylium
Peucedanum ostruthium	Peucedanum ostruthium
Sonnentaugewächse	Droseraceae
Rundblättriger Sonnentau	Drosera rotundifolia
Zistrosengewächse	Cistaceae
Ovalblättriges Sonnenröschen	Helianthemum ovatum
Veilchengewächse	Violaceae
Zweiblütiges Veilchen	Viola biflora
Langsporniges Stiefmütterchen	Viola calcarata
Wald-Veilchen	Viola reichenbachiana
Echtes Stiefmütterchen	Viola tricolor
Kreuzblütler	Brassicaceae
Felsen-Kugelschötchen	Kernera saxatilis
Knoblauchhederich	Alliaria petiolata
Schotenkresse	Arabidopsis thaliana
Alpen-Gänsekresse	Arabis alpina
Schaumkraut	Cardamine
Behaartes Schaumkraut	Cardamine hirsuta
Wiesen-Schaumkraut	Cardamine pratensis
Resedablättriges Schaumkraut	Cardamine resedifolia
Gewöhnliches Brillenschötchen	Biscutella levigata
Gewöhnliches Hirtentäschchen	Capsella bursa-pastoris
Alpen-Gemskresse	Hutchinsia alpina
Acker-Täschelkraut	Thlaspi arvense
Lindengewächse	Tiliaceae
Linde	Tilia
Winter-Linde	Tilia cordata
Sommer-Linde	Tilia platyphyllos
Primelgewächse	Primulaceae
Hain-Gilbweiderich	Lysimachia nemorum
Mannsschild	Androsace
Zwerg-Mannsschild	Androsace chamaejasme
Primel	Primula
Aurikel	Primula auricula
Wald-Schlüsselblume	Primula elatior
Mehl-Primel	Primula farinosa
Frühlings-Schlüsselblume	Primula veris
Soldanelle	Soldanella
Grosse Soldanelle	Soldanella alpina
Stechpalmengewächse	Aquifoliaceae
Stechpalme	Ilex aquifolium
Hornstrauchgewächse	Cornaceae
Hartriegel	Cornus sanguinea
Heidekrautartige	Ericales
Heidekrautgewächse	Ericaceae
Bärentraube	Arctostaphylos uva-ursi
Besenheide	Calluna vulgaris
Erika	Erica carnea
Alpenazalee	Loiseleuria procumbens
Alpenrose	Rhododendron
Rostblättrige Alpenrose	Rhododendron ferrugineum
Bewimperte Alpenrose	Rhododendron hirsutum
Heidelbeere	Vaccinium myrtillus
Moorbeere	Vaccinium uliginosum
Preiselbeere	Vaccinium vitis-idaea
Kardenartige	Dipsacales
Geissblattgewächse	Caprifoliaceae
Heckenkirsche	Lonicera
Blaue Heckenkirsche	Lonicera caerulea
Rote Heckenkirsche	Lonicera xylosteum
Holunder	Sambucus
Schwarzer Holunder	Sambucus nigra
Roter Holunder	Sambucus racemosa
Schneeball	Viburnum
Wolliger Schneeball	Viburnum lantana
Gewöhnlicher Schneeball	Viburnum opulus
Kardengewächse	Dipsacaceae
Acker-Witwenblume	Knautia arvensis
Gewöhnliche Skabiose	Scabiosa columbaria
Baldriangewächse	Valerianaceae
Baldrian	Valeriana
Berg-Baldrian	Valeriana montana
Gewöhnlicher Baldrian	Valeriana officinalis
Dreiblatt-Baldrian	Valeriana tripteris
Ölbaumgewächse	Oleaceae
Esche	Fraxinus
Gewöhnliche Esche	Fraxinus excelsior
Liguster	Ligustrum vulgare
Enzianartige	Gentianales
Seidenpflanzengewächse	Asclepiadaceae
Schwalbenwurz	Vincetoxicum hirundinaria
Enziangewächse	Gentianaceae
Clusius Enzian	Gentiana clusii
Stengelloser Enzian	Gentiana acaulis
Frühlings-Enzian	Gentiana verna
Rötegewächse	Rubiaceae
Labkraut	Galium
Weisses Labkraut	Galium album
Kletten-Labkraut	Galium aparine
Waldmeister	Galium odoratum
Tubiflorae	Tubiflorae
Solanaceae	Solanaceae
Atropa belladonna	Atropa belladonna
Solanum dulcamara	Solanum dulcamara
Boraginaceae	Boraginaceae
Echium vulgare	Echium vulgare
Myosotis	Myosotis
Symphytum officinale	Symphytum officinale
Scrophulariales	Scrophulariales
Scrophulariaceae	Scrophulariaceae
Veronica	Veronica
Veronica bellidioides	Veronica bellidioides
Veronica chamaedrys	Veronica chamaedrys
Veronica filiformis	Veronica filiformis
Veronica fruticans	Veronica fruticans
Rhinanthus	Rhinanthus
Rhinanthus alectorolophus	Rhinanthus alectorolophus
Linaria	Linaria
Linaria alpina	Linaria alpina
Bartsia alpina	Bartsia alpina
Euphrasia rostkoviana	Euphrasia rostkoviana
Melampyrum silvaticum	Melampyrum silvaticum
Pedicularis	Pedicularis
Pedicularis tuberosa	Pedicularis tuberosa
Pedicularis verticillata	Pedicularis verticillata
Orobanchaceae	Orobanchaceae
Orobanche alba	Orobanche alba
Globulariaceae	Globulariaceae
Globularia cordifolia	Globularia cordifolia
Lentibulariaceae	Lentibulariaceae
Pinguicula	Pinguicula
Plantaginaceae	Plantaginaceae
Plantago alpina	Plantago alpina
Plantago lanceolata	Plantago lanceolata
Plantago major	Plantago major
Plantago media	Plantago media
Lamiaceae	Lamiaceae
Ajuga	Ajuga
Ajuga reptans	Ajuga reptans
Galeopsis	Galeopsis
Galeopsis tetrahit	Galeopsis tetrahit
Glechoma hederacea	Glechoma hederacea
Lamium	Lamium
Lamium maculatum	Lamium maculatum
Lamium montanum	Lamium montanum
Lamium purpureum	Lamium purpureum
Prunella vulgaris	Prunella vulgaris
Salvia pratensis	Salvia pratensis
Acinos alpina	Acinos alpina
Thymus serpyllum	Thymus serpyllum
Glockenblumengewächse	Campanulaceae
Glockenblume	Campanula
Bärtige Glockenblume	Campanula barbata
Kleine Glockenblume	Campanula cochleariifolia
Rautenblättrige Glockenblume	Campanula rhomboidalis
Rundblättrige Glockenblume	Campanula rotundifolia
Rapunzel	Phyteuma
Halbkugelige Rapunzel	Phyteuma hemisphaericum
Rundköpfige Rapunzel	Phyteuma orbiculare
Ährige Rapunzel	Phyteuma spicatum
Korbblütler	Asteraceae
Röhrenblütler	Asteroideae
Arnika	Arnica montana
Distel	Carduus
Kratzdistel	Cirsium
Alpenlattich	Homogyne alpina
Pestwurz	Petasites
Huflattich	Tussilago farfara
Kamille	Matricaria
Echte Kamille	Matricaria recutita
Strahlenlose Kamille	Matricaria discoidea
Grauer Alpendost	Adenostyles alliariae
Gewöhnliches Katzenpfötchen	Antennaria dioica
Beifuss	Artemisia
Wermut	Artemisia absinthium
Feld-Beifuss	Artemisia campestris
Gewöhnlicher Beifuss	Artemisia vulgaris
Flockenblume	Centaurea
Wiesen-Flockenblume	Centaurea jacea
Berg-Flockenblume	Centaurea montana
Skabiosen-Flockenblume	Centaurea scabiosa
Edelweiss	Leontopodium alpinum
Schafgarbe	Achillea
Gewöhnliche Schafgarbe	Achillea millefolium
Moschus-Schafgarbe	Achillea moschata
Alpen-Aster	Aster alpinus
Alpenmasslieb	Aster bellidiastrum
Gänseblümchen	Bellis perennis
Alpenmargerite	Leucanthemopsis alpina
Gewöhnliche Margerite	Leucanthemum vulgare
Kreuzkraut	Senecio
Gemswurz-Kreuzkraut	Senecio doronicum
Gewöhnliches Kreuzkraut	Senecio vulgaris
Zungenblütler	Cichorioideae
Pippau	Crepis
Gold-Pippau	Crepis aurea
Wiesen-Pippau	Crepis biennis
Habichtskraut	Hieracium
Mauer-Habichtskraut	Hieracium murorum
Langhaariges Habichtskraut	Hieracium pilosella
Steifhaariger Löwenzahn	Leontodon hispidus
Pfaffenröhrlein	Taraxacum officinale
Wiesen-Bocksbart	Tragopogon orientalis
Buchenartige	Fagales
Buchengewächse	Fagaceae
Edel-Kastanie	Castanea sativa
Buche	Fagus sylvatica
Eiche	Quercus
Birkengewächse	Betulaceae
Erle	Alnus
Schwarz-Erle	Alnus glutinosa
Grau-Erle	Alnus incana
Alpen-Erle	Alnus viridis
Birke	Betula
Hagebuche	Carpinus betulus
Haselstrauch	Corylus avellana
Walnussgewächse	Juglandaceae
Walnussbaum	Juglans regia
Weidengewächse	Salicaceae
Pappel	Populus
Silber-Pappel	Populus alba
Zitter-Pappel	Populus tremula
Weide	Salix
Sal-Weide	Salix caprea
Purpur-Weide	Salix purpurea
Kraut-Weide	Salix herbacea
Netz-Weide	Salix reticulata
Stumpfblättrige Weide	Salix retusa
Einkeimblättrige	Monocotyledoneae
Lilienartige	Liliales
Liliengewächse	Liliaceae
Lauch	Allium
Bärlauch	Allium ursinum
Herbst-Zeitlose	Colchicum autumnale
Maiglöcklein	Convallaria majalis
Vierblättrige Einbeere	Paris quadrifolia
Salomonssiegel	Polygonatum
Vielblütiges Salomonssiegel	Polygonatum multiflorum
Echtes Salomonssiegel	Polygonatum odoratum
Gewöhnlicher Germer	Veratrum lobelianum
Amaryllisgewächse	Amaryllidaceae
Schneeglöckchen	Galanthus nivalis
Märzenglöckchen	Leucojum vernum
Osterglocke	Narcissus pseudonarcissus
Schwertliliengewächse	Iridaceae
Frühlings-Krokus	Crocus albiflorus
Gelbe Schwertlilie	Iris pseudacorus
Orchideen	Orchidaceae
Grüne Hohlzunge	Coeloglossum viride
Mücken-Nacktdrüse	Gymnadenia conopsea
Nestwurz	Neottia nidus-avis
Männertreu	Nigritella nigra
Orchis	Orchis
Stattliche Orchis	Orchis mascula
Binsengewächse	Juncaceae
Binse	Juncus
Alpen-Binse	Juncus alpinoarticulatus
Blaugrüne Binse	Juncus inflexus
Hainsimse	Luzula
Feld-Hainsimse	Luzula campestris
Luzula silvatica	Luzula silvatica
Sauergräser	Cyperaceae
Wollgras	Eriophorum
Schmalblättriges Wollgras	Eriophorum angustifolium
Rasige Haarbinse	Trichophorum caespitosum
Segge	Carex
Davalls Segge	Carex davalliana
Krumm-Segge	Carex curvula
Gedrängtährige Segge	Carex spicata
Igelfrüchtige Segge	Carex echinata
Geschwärzte Segge	Carex atrata
Braune Segge	Carex nigra
Steife Segge	Carex elata
Behaarte Segge	Carex hirta
Schlaffe Segge	Carex flacca
Gelbe Segge	Carex flava
Immergrüne Segge	Carex sempervirens
Wald-Segge	Carex sylvatica
Süssgräser	Poaceae
Gewöhnliches Ruchgras	Anthoxantum odoratum
Gewöhnliches Zittergras	Briza media
Gewöhnliches Knäuelgras	Dactylis glomerata
Borstgras	Nardus stricta
Schilf	Phragmites australis
Sesleria caerulea	Sesleria caerulea
Kriechende Quecke	Agropyron repens
Wiesen-Fuchsschwanz	Alopecurus pratensis
Cynosurus cristatus	Cynosurus cristatus
Mäuse-Gerste	Hordeum murinum
Lolch	Lolium
Englisches Raygras	Lolium perenne
Italienisches Raygras	Lolium multiflorum
Perlgras	Melica
Nickendes Perlgras	Melica nutans
Wiesen-Lieschgras	Phleum pratense
Federgras	Stipa pennata
Arrhenatherum elatius	Arrhenatherum elatius
Trespe	Bromus
Aufrechte Trespe	Bromus erectus
Weiche Trespe	Bromus hordeaceus
Taube Trespe	Bromus sterilis
Dach-Trespe	Bromus tectorum
Festuca	Festuca
Festuca pratensis	Festuca pratensis
Festuca rubra	Festuca rubra
Festuca vallesiaca	Festuca vallesiaca
Flaumhafer	Helictotrichon pubescens
Wolliges Honiggras	Holcus lanatus
Rispengras	Poa
Alpen-Rispengras	Poa alpina
Einjähriges Rispengras	Poa annua
Knolliges Rispengras	Poa bulbosa
Wiesen-Rispengras	Poa pratensis
Gewöhnliches Rispengras	Poa trivialis
Goldhafer	Trisetum flavescens
Aronstabgewächse	Araceae
Aronstab	Arum maculatum
Lebermoose	Marchantiatae
Laubmoose	Bryatae
Landkartenflechte	Rhizocarpon geographicum
Bartflechte	Usnea scabrata
Riesen-Schachtelhalm	Equisetum telmateia
Streifenfarngewächse	Aspleniaceae
Athyriaceae	Athyriaceae
Aspidiaceae	Aspidiaceae
Adlerfarn	Pteridium aquilinum
Rippenfarn	Blechnum spicant
Gewöhnlicher Blasenfarn	Cystopteris fragilis
Narzisse	Narcissus
Dichter-Narzisse	Narcissus poeticus
Frühlings-Segge	Carex caryophyllea
Gefingerte Segge	Carex digitata
Rost-Segge	Carex ferruginea
Polster-Segge	Carex firma
Bleiche Segge	Carex pallescens
Hirsen-Segge	Carex panicea
Nacktriedbinse	Elyna myosuroides
Breitblättriges Wollgras	Eriophorum latifolium
Scheuchzers Wollgras	Eriophorum scheuchzeri
Scheidiges Wollgras	Eriophorum vaginatum
Rostrote Kopfbinse	Schoenus ferrugineus
Waldbinse	Scirpus sylvaticus
Schwertlilie	Iris
Sibirische Schwertlilie	Iris sibirica
Flatter-Binse	Juncus effusus
Dreispaltige Binse	Juncus trifidus
Behaarte Hainsimse	Luzula pilosa
Wasserlinsengewächse	Lemnaceae
Kleine Wasserlinse	Lemna minor
Schnittlauch	Allium schoenoprasum
Türkenbund	Lilium martagon
Faltenlilie	Lloydia serotina
Zweiblättrige Schattenblume	Maianthemum bifolium
Quirlblättriges Salomonssiegel	Polygonatum verticillatum
Kelch-Liliensimse	Tofieldia calyculata
Weinberg-Tulpe	Tulipa sylvestris
Frauenschuh	Cypripedium calceolus
Dactylorhiza majalis	Dactylorhiza majalis
Grosses Zweiblatt	Listera ovata
Fliegen-Ragwurz	Ophrys insectifera
Schwärzliche Orchis	Orchis ustulata
Kriechendes Straussgras	Agrostis stolonifera
Gewöhnlicher Windhalm	Apera spica-venti
Saat-Hafer	Avena sativa
Fieder-Zwenke	Brachypodium pinnatum
Buntes Reitgras	Calamagrostis varia
Rasen-Schmiele	Deschampsia caespitosa
Festuca arundinacea	Festuca arundinacea
Gerste	Hordeum
Saat-Gerste	Hordeum vulgare
Waldhirse	Milium effusum
Blaues Pfeifengras	Molinia caerulea
Roggen	Secale cereale
Gewöhnlicher Weizen	Triticum aestivum
Mais	Zea mays
Zwenke	Brachypodium
Rohrkolbengewächse	Typhaceae
Breitblättriger Rohrkolben	Typha latifolia
Seerosengewächse	Nymphaeaceae
Weisse Seerose	Nymphaea alba
Grosse Teichrose	Nuphar lutea
Blauer Eisenhut	Aconitum napellus
Gelber Eisenhut	Aconitum vulparia
Frühlings-Adonisröschen	Adonis aestivalis
Anemone	Anemone
Acker-Rittersporn	Consolida regalis
Stinkende Nieswurz	Helleborus foetidus
Gletscher-Hahnenfuss	Ranunculus glacialis
Pyrenäen-Hahnenfuss	Ranunculus kuepferi
Paronychienartige	Paronychioideae
Kahles Bruchkraut	Herniaria glabra
Rote Schuppenmiere	Spergularia rubra
Arenaria	Arenaria
Minuartia	Minuartia
Aufrechtes Hornkraut	Cerastium strictum
Wald-Sternmiere	Stellaria nemorum
Zweiblütiges Sandkraut	Arenaria biflora
Quendelblättriges Sandkraut	Arenaria serpyllifolia
Frühlings-Miere	Minuartia verna
Zwerg-Miere	Minuartia sedoides
Pracht-Nelke	Dianthus superbus
Seifenkraut	Saponaria
Gewöhnliches Seifenkraut	Saponaria officinalis
Kuckucks-Lichtnelke	Silene flos-cuculi
Weisse Waldnelke	Silene latifolia
Runkelrübe	Beta vulgaris
Fuchsschwanzgewächse	Amaranthaceae
Zurückgekrümmter Fuchsschwanz	Amaranthus retroflexus
Säuerling	Oxyria digyna
Japanischer Staudenknöterich	Reynoutria japonica
Vogel-Knöterich	Polygonum aviculare
Pfirsichblättriger Knöterich	Polygonum persicaria
Hänge-Birke	Betula pendula
Moor-Birke	Betula pubescens
Flaum-Eiche	Quercus pubescens
Stiel-Eiche	Quercus robur
Trauben-Eiche	Quercus petraea
Hanf	Cannabis sativa
Spinnweb-Hauswurz	Sempervivum arachnoideum
Sempervivum montanum	Sempervivum montanum
Weisser Mauerpfeffer	Sedum album
Scharfer Mauerpfeffer	Sedum acre
Dunkler Mauerpfeffer	Sedum atratum
Wechselblättriges Milzkraut	Chrysosplenium alternifolium
Steinbrech	Saxifraga
Moosartiger Steinbrech	Saxifraga bryoides
Blaugrüner Steinbrech	Saxifraga caesia
Herzblattgewächse	Parnassiaceae
Studentenröschen	Parnassia palustris
Felsenmispel	Amelanchier ovalis
Gewöhnliche Steinmispel	Cotoneaster integerrima
Eingriffliger Weissdorn	Crataegus monogyna
Holz-Apfelbaum	Malus sylvestris
Crantz Fingerkraut	Potentilla crantzii
Erdbeer-Fingerkraut	Potentilla sterilis
Süsskirsche	Prunus avium
Wild-Birnbaum	Pyrus pyraster
Brombeere	Rubus fruticosus
Himbeere	Rubus idaeus
Elsbeerbaum	Sorbus torminalis
Sibbaldie	Sibbaldia procumbens
Gletscher-Tragant	Astragalus frigidus
Alpen-Süssklee	Hedysarum hedysaroides
Frühlings-Platterbse	Lathyrus vernus
Sichelklee	Medicago falcata
Saat-Luzerne	Medicago sativa
Honigklee	Melilotus
Weisser Honigklee	Melilotus albus
Gewöhnlicher Honigklee	Melilotus officinalis
Robinie	Robinia pseudoacacia
Kleiner Klee	Trifolium dubium
Gewöhnliches Hexenkraut	Circaea lutetiana
Gewöhnliche Nachtkerze	Oenothera biennis
Schmalblättriges Weidenröschen	Epilobium angustifolium
Berg-Weidenröschen	Epilobium montanum
Rundblättriger Storchschnabel	Geranium rotundifolium
Balsaminaceae	Balsaminaceae
Impatiens parviflora	Impatiens parviflora
Impatiens noli-tangere	Impatiens noli-tangere
Impatiens glandulifera	Impatiens glandulifera
Sonnenwend-Wolfsmilch	Euphorbia helioscopia
Seidelbastgewächse	Thymelaeaceae
Gewöhnlicher Seidelbast	Daphne mezereum
Gestreifter Seidelbast	Daphne striata
Astrantia major	Astrantia major
Chaerophyllum villarsii	Chaerophyllum villarsii
Daucus carota	Daucus carota
Ligusticum mutellina	Ligusticum mutellina
Sanicula europaea	Sanicula europaea
Heracleum mantegazzianum	Heracleum mantegazzianum
Heracleum	Heracleum
Johanniskrautgewächse	Hypericaceae
Gewöhnliches Johanniskraut	Hypericum perforatum
Acker-Stiefmütterchen	Viola arvensis
Kohl	Brassica
Raps	Brassica napus
Gemüse-Kohl	Brassica oleracea
Immergrünes Felsenblümchen	Draba aizoides
Silberling	Lunaria annua
Acker-Senf	Sinapis arvensis
Silber-Weide	Salix alba
Lavendel-Weide	Salix elaeagnos
Malvengewächse	Malvaceae
Kleine Malve	Malva neglecta
Wilde Malve	Malva sylvestris
Acker-Gauchheil	Anagallis arvensis
Alpen-Mannsschild	Androsace alpina
Schweizer Mannsschild	Androsace helvetica
Stumpfblättriger Mannsschild	Androsace obtusifolia
Vandellis Mannsschild	Androsace vandellii
Rote Felsen-Primel	Primula hirsuta
Kornelkirsche	Cornus mas
Krähenbeerengewächse	Empetraceae
Zwittrige Krähenbeere	Empetrum hermaphroditum
Alpen-Heckenkirsche	Lonicera alpigena
Schwarze Heckenkirsche	Lonicera nigra
Nüsslisalat	Valerianella locusta
Blumen-Esche	Fraxinus ornus
Hundsgiftgewächse	Apocynaceae
Kleines Immergrün	Vinca minor
Feld-Enzian	Gentiana campestris
Deutscher Enzian	Gentiana germanica
Gelber Enzian	Gentiana lutea
Punktierter Enzian	Gentiana punctata
Purpur-Enzian	Gentiana purpurea
Gewöhnliches Kreuzlabkraut	Cruciata laevipes
Kreuzlabkraut	Cruciata
Meister	Asperula
Hügel-Meister	Asperula cynanchica
Ungleichblättriges Labkraut	Galium anisophyllum
Gelbes Labkraut	Galium verum
Solanales	Solanales
Convolvulaceae	Convolvulaceae
Calystegia sepium	Calystegia sepium
Convolvulus arvensis	Convolvulus arvensis
Cuscuta epithymum	Cuscuta epithymum
Cuscutaceae	Cuscutaceae
Solanum	Solanum
Solanum tuberosum	Solanum tuberosum
Datura stramonium	Datura stramonium
Myosotis alpestris	Myosotis alpestris
Myosotis arvensis	Myosotis arvensis
Eritrichium nanum	Eritrichium nanum
Pulmonaria obscura	Pulmonaria obscura
Pinguicula alpina	Pinguicula alpina
Pinguicula vulgaris	Pinguicula vulgaris
Plantago atrata	Plantago atrata
Chaenorrhinum minus	Chaenorrhinum minus
Digitalis grandiflora	Digitalis grandiflora
Verbascum lychnitis	Verbascum lychnitis
Linaria vulgaris	Linaria vulgaris
Melampyrum	Melampyrum
Melampyrum pratense	Melampyrum pratense
Rhinanthus minor	Rhinanthus minor
Veronica arvensis	Veronica arvensis
Veronica persica	Veronica persica
Veronica hederifolia	Veronica hederifolia
Veronica beccabunga	Veronica beccabunga
Lamiales	Lamiales
Verbenaceae	Verbenaceae
Verbena officinalis	Verbena officinalis
Ajuga pyramidalis	Ajuga pyramidalis
Mentha	Mentha
Mentha arvensis	Mentha arvensis
Origanum vulgare	Origanum vulgare
Salvia	Salvia
Salvia glutinosa	Salvia glutinosa
Stachys	Stachys
Stachys recta	Stachys recta
Stachys sylvatica	Stachys sylvatica
Teucrium	Teucrium
Teucrium montanum	Teucrium montanum
Wiesen-Glockenblume	Campanula patula
Betonienblättrige Rapunzel	Phyteuma betonicifolium
Schwarzrandige Schafgarbe	Achillea atrata
Grossblättrige Schafgarbe	Achillea macrophylla
Aster	Aster
Berg-Distel	Carduus defloratus
Kletten-Distel	Carduus personata
Silberdistel	Carlina acaulis
Kornblume	Centaurea cyanus
Stachlige Kratzdistel	Cirsium spinosissimum
Kohldistel	Cirsium oleraceum
Acker-Kratzdistel	Cirsium arvense
Gemswurz	Doronicum
Clusius Gemswurz	Doronicum clusii
Grossköpfige Gemswurz	Doronicum grandiflorum
Berufkraut	Erigeron
Alpen-Berufkraut	Erigeron alpinus
Einjähriges Berufkraut	Erigeron annuus
Wasserdost	Eupatorium cannabinum
Zwerg-Ruhrkraut	Gnaphalium supinum
Einjährige Sonnenblume	Helianthus annuus
Weisse Pestwurz	Petasites albus
Gewöhnliche Pestwurz	Petasites hybridus
Alpen-Kreuzkraut	Senecio alpinus
Graues Kreuzkraut	Senecio incanus
Goldrute	Solidago
Spätblühende Goldrute	Solidago gigantea
Echte Goldrute	Solidago virgaurea
Wegwarte	Cichorium intybus
Zottiges Habichtskraut	Hieracium villosum
Löwenzahn	Leontodon
Schweizer Löwenzahn	Leontodon helveticus
Hasenlattich	Prenanthes purpurea
Kohl-Gänsedistel	Sonchus oleraceus
Thallose Lebermoose	Marchantiidae
Beblätterte Lebermoose	Jungermaniidae
Echte Laubmoose	Bryidae
Torfmoose	Sphagnidae
Aronstabartige	Arales
Kleinblütige Segge	Carex parviflora
Selaginella helvetica	Selaginella helvetica
Marattiaceae	Marattiaceae
Ophioglossum vulgatum	Ophioglossum vulgatum
Dryopteris carthusiana	Dryopteris carthusiana
Engelsüss	Polypodium vulgare
Rippenfarngewächse	Blechnaceae
Tüpfelfarngewächse	Polypodiaceae
Adlerfarngewächse	Pteridiaceae
Wald-Zwenke	Brachypodium sylvaticum
Melica uniflora	Melica uniflora
Poeae	Poeae
Diverseae	Diverseae
Aveneae	Aveneae
Triticeae	Triticeae
Agrostideae	Agrostideae
Magnoliidae	Magnoliidae
Ranunculidae	Ranunculidae
Caryophyllidae	Caryophyllidae
Hamamelididae	Hamamelididae
Rosidae	Rosidae
Stachelbeergewächse	Grossulariaceae
Felsen-Johannisbeere	Ribes petraeum
Dilleniidae	Dilleniidae
Lamiidae	Lamiidae
Asteridae	Asteridae
Buddlejaceae	Buddlejaceae
Dummy Antiweizen	Dummy Antiweizen
Poaceae 2	Poaceae 2
Festuca	Festuca
Lolium	Lolium
Melica	Melica
Poa	Poa
Apera spica-venti	Apera spica-venti
Briza media	Briza media
Cynosurus cristatus	Cynosurus cristatus
Dactylis glomerata	Dactylis glomerata
Sesleria caerulea	Sesleria caerulea
1: lockere Rispe, mehrblütige Ä	1: lockere Rispe, mehrblütige Ä
2: lockere Rispe, 1blütige Ä	2: lockere Rispe, 1blütige Ä
3: keine lockere Rispe	3: keine lockere Rispe
Festuca arundinacea	Festuca arundinacea
Festuca pratensis	Festuca pratensis
Festuca rubra	Festuca rubra
Festuca vallesiaca	Festuca vallesiaca
Poa annua	Poa annua
Poa alpina	Poa alpina
Poa bulbosa	Poa bulbosa
Poa pratensis	Poa pratensis
Poa trivialis	Poa trivialis
Lolium multiflorum	Lolium multiflorum
Lolium perenne	Lolium perenne
Melica nutans	Melica nutans
Melica ciliata	Melica ciliata
Brachypodium	Brachypodium
Bromus	Bromus
Molinia caerulea	Molinia caerulea
Nardus stricta	Nardus stricta
Phragmites australis	Phragmites australis
Stipa pennata	Stipa pennata
Zea mays	Zea mays
Brachypodium sylvaticum	Brachypodium sylvaticum
Brachypodium pinnatum	Brachypodium pinnatum
Bromus erectus	Bromus erectus
Bromus sterilis	Bromus sterilis
Bromus tectorum	Bromus tectorum
Bromus hordeaceus	Bromus hordeaceus
Anthoxantum odoratum	Anthoxantum odoratum
Arrhenatherum elatius	Arrhenatherum elatius
Avena sativa	Avena sativa
Deschampsia caespitosa	Deschampsia caespitosa
Helictrotrichon pubescens	Helictrotrichon pubescens
Trisetum flavescens	Trisetum flavescens
Hordeum	Hordeum
Agropyron repens	Agropyron repens
Secale cereale	Secale cereale
Triticum aestivum	Triticum aestivum
Hordeum murinum	Hordeum murinum
Hordeum vulgare	Hordeum vulgare
Agrostis stolonifera	Agrostis stolonifera
Alopecurus pratensis	Alopecurus pratensis
Phleum pratense	Phleum pratense
Calamagrostis varia	Calamagrostis varia
Milium effusum	Milium effusum
Outgroup	Outgroup
Outgroup	Outgroup
Holcus lanatus	Holcus lanatus
ohne Honigblätter	ohne Honigblätter
mit Honigblättern	mit Honigblättern
Wurmfarngewächse	Dryopteridaceae
Athyrium filix-femina	Athyrium filix-femina
Geflecktes Knabenkraut	Dactylorhiza maculata
Wald-Hainsimse	Luzula sylvatica
Seidelbast	Daphne
dummy	dummy
Buddleja davidii	Buddleja davidii
Plantago	Plantago
Buddleja davidii	Buddleja davidii
Gipfelmoos	Laubmoos akrokarp
Astmoos	Laubmoos pleurokarp
Adonisröschen	Adonis
xx	xx
Mohngewächse	Papaveraceae
Klatsch-Mohn	Papaver rhoeas
Schöllkraut	Chelidonium majus
Rosenartige	Rosoideae
Steinobstartige	Prunoideae
Kernobstartige	Maloideae
xx	xx
xx	xx
xx	xx
Ahorngewächse	Aceraceae
xx	xx
Acer campestre	Acer campestre
Feld-Ahorn	Acer campestre
Spitz-Ahorn	Acer platanoides
Berg-Ahorn	Acer pseudoplatanus
Springkrautgewächse	Balsaminaceae
Springkraut	Impatiens
Drüsiges Springkraut	Impatiens glandulifera
Rühr-mich-nicht-an	Impatiens noli-tangere
Kleinblütiges Springkraut	Impatiens parviflora
Doldenartige	Araliales
Efeugewächse	Araliaceae
Doldengewächse	Apiaceae
Efeu	Hedera helix
Kümmel	Carum carvi
Karotte	Daucus carota
Muttern	Ligusticum mutellina
Wiesen-Kerbel	Anthriscus sylvestris
Villars Kerbel	Chaerophyllum villarsii
Baumtropfen	Aegopodium podagraria
Grosse Sterndolde	Astrantia major
Bärenklau	Heracleum
Riesen-Bärenklau	Heracleum mantegazzianum
Wiesen-Bärenklau	Heracleum sphondylium
Meisterwurz	Peucedanum ostruthium
Sanikel	Sanicula europaea
Viola	Viola
xx	xx
Malve	Malva
xx	xx
Hornstrauch	Cornus
xx	xx
Witwenblume	Knautia
Skabiose	Scabiosa
xx	xx
xx	xx
Röhrenblütige	Tubiflorae
Asterartige	Asteridae
xx	xx
Braunwurzartige	Scrophulariales
Nachtschattenartige	Solanales
Taubnesselartige	Lamiales
Rauhhaargewächse	Boraginaceae
Windengewächse	Convolvulaceae
Seidengewächse	Cuscutaceae
Nachtschattengewächse	Solanaceae
Zaunwinde	Calystegia sepium
Acker-Winde	Convolvulus arvensis
Teufelszwirn	Cuscuta epithymum
Tollkirsche	Atropa belladonna
Stechapfel	Datura stramonium
Nachtschatten	Solanum
Bittersüss	Solanum dulcamara
Kartoffel	Solanum tuberosum
Natterkopf	Echium vulgare
Himmelsherold	Eritrichium nanum
Vergissmeinnicht	Myosotis
Alpen-Vergissmeinnicht	Myosotis alpestris
Acker-Vergissmeinnicht	Myosotis arvensis
Dunkelgrünes Lungenkraut	Pulmonaria obscura
Echte Wallwurz	Symphytum officinale
Schmetterlingsstrauchgewächse	Buddlejaceae
Kugelblumengewächse	Globulariaceae
Wasserschlauchgewächse	Lentibulariaceae
Sommerwurzgewächse	Orobanchaceae
Wegerichgewächse	Plantaginaceae
Braunwurzgewächse	Scrophulariaceae
Sommerflieder	Buddleja davidii
Herzblättrige Kugelblume	Globularia cordifolia
Fettblatt	Pinguicula
Alpen-Fettblatt	Pinguicula alpina
Gewöhnliches Fettblatt	Pinguicula vulgaris
Thymian-Sommerwurz	Orobanche alba
Wegerich	Plantago
Alpen-Wegerich	Plantago alpina
Berg-Wegerich	Plantago atrata
Spitz-Wegerich	Plantago lanceolata
Breit-Wegerich	Plantago major
Mittlerer Wegerich	Plantago media
Ehrenpreis	Veronica
Bachbungen-Ehrenpreis	Veronica beccabunga
Gamander-Ehrenpreis	Veronica chamaedrys
Feld-Ehrenpreis	Veronica arvensis
Rosetten-Ehrenpreis	Veronica bellidioides
Feinstieliger Ehrenpreis	Veronica filiformis
Felsen-Ehrenpreis	Veronica fruticans
Efeublättriger Ehrenpreis	Veronica hederifolia
Persischer Ehrenpreis	Veronica persica
Kleines Leinkraut	Chaenorrhinum minus
Grossblütiger Fingerhut	Digitalis grandiflora
Leinkraut	Linaria
Alpen-Leinkraut	Linaria alpina
Gewöhnliches Leinkraut	Linaria vulgaris
Alpen-Bartschie	Bartsia alpina
Gewöhnlicher Augentrost	Euphrasia rostkoviana
Wachtelweizen	Melampyrum
Wiesen-Wachtelweizen	Melampyrum pratense
Wald-Wachtelweizen	Melampyrum sylvaticum
Läusekraut	Pedicularis
Knolliges Läusekraut	Pedicularis tuberosa
Quirlblättriges Läusekraut	Pedicularis verticillata
Klappertopf	Rhinanthus
Behaarter Klappertopf	Rhinanthus alectorolophus
Kleiner Klappertopf	Rhinanthus minor
Lampen-Königskerze	Verbascum lychnitis
Lippenblütler	Lamiaceae
Eisenkrautgewächse	Verbenaceae
Eisenkraut	Verbena officinalis
Günsel	Ajuga
Pyramiden-Günsel	Ajuga pyramidalis
Kriechender Günsel	Ajuga reptans
Gewöhnliche Gundelrebe	Glechoma hederacea
Gamander	Teucrium
Berg-Gamander	Teucrium montanum
Alpen-Steinquendel	Acinos alpinus
Hohlzahn	Galeopsis
Gewöhnlicher Hohlzahn	Galeopsis tetrahit
Taubnessel	Lamium
Weisse Taubnessel	Lamium album
Gefleckte Taubnessel	Lamium maculatum
Berg-Goldnessel	Lamium montanum
Purpur-Taubnessel	Lamium purpureum
Gewöhnliche Brunelle	Prunella vulgaris
Salbei	Salvia
Klebrige Salbei	Salvia glutinosa
Wiesen-Salbei	Salvia pratensis
Ziest	Stachys
Aufrechter Ziest	Stachys recta
Wald-Ziest	Stachys sylvatica
Dost	Origanum vulgare
Feld-Thymian	Thymus serpyllum
Acker-Minze	Mentha arvensis
Knabenkraut	Dactylorhiza
xx	xx
Ragwurz	Ophrys
x	x
Glatthafer	Arrhenatherum elatius
Schwingel	Festuca
Rohr-Schwingel	Festuca arundinacea
Wiesen-Schwingel	Festuca pratensis
Rot-Schwingel	Festuca rubra
Walliser Schwingel	Festuca valesiaca
Gewöhnliches Kammgras	Cynosurus cristatus
Blaugras	Sesleria caerulea
sax	sax
Storchschnabelartige	Geraniales
lijliu	lijliu
Berg-Hauswurz	Sempervivum montanum
