ch.jfactory.projecttime	C:/Daten/Daten/All/Workspace/Common/App/JProjectTime/pom.xml
ch.jfactory	C:/Daten/Daten/All/Workspace/Common/App/pom.xml
ch.xmatrix.common.build	C:/Daten/Daten/All/Workspace/Common/Build/pom.xml
ch.xmatrix.common.icon	C:/Daten/Daten/All/Workspace/Common/Icon/pom.xml
ch.xmatrix.common	C:/Daten/Daten/All/Workspace/Common/pom.xml
ch.xmatrix.common.utils-all	C:/Daten/Daten/All/Workspace/Common/Util-All/pom.xml
ch.xmatrix.ups.data.constraints	C:/Daten/Daten/All/Workspace/Data/Constraints/pom.xml
ch.xmatrix.ups.data.courses	C:/Daten/Daten/All/Workspace/Data/Courses/pom.xml
ch.xmatrix.ups.data.exams	C:/Daten/Daten/All/Workspace/Data/Exams/pom.xml
ch.xmatrix.ups.data	C:/Daten/Daten/All/Workspace/Data/pom.xml
ch.xmatrix.ups.data.sessions	C:/Daten/Daten/All/Workspace/Data/Sessions/pom.xml
ch.xmatrix.ups.data.taxa	C:/Daten/Daten/All/Workspace/Data/Taxa/pom.xml
ch.xmatrix.le.application	C:/Daten/Daten/All/Workspace/HCD/Application/pom.xml
ch.xmatrix.le.catcher	C:/Daten/Daten/All/Workspace/HCD/Catcher/pom.xml
ch.xmatrix.le.data	C:/Daten/Daten/All/Workspace/HCD/Data/pom.xml
ch.xmatrix.le.gallows	C:/Daten/Daten/All/Workspace/HCD/Gallows/pom.xml
ch.xmatrix.le.help	C:/Daten/Daten/All/Workspace/HCD/Help/pom.xml
ch.xmatrix.le.lesson	C:/Daten/Daten/All/Workspace/HCD/Lesson/pom.xml
ch.xmatrix.le.maze	C:/Daten/Daten/All/Workspace/HCD/Maze/pom.xml
ch.xmatrix.le.modeapi	C:/Daten/Daten/All/Workspace/HCD/ModeAPI/pom.xml
ch.xmatrix.le.model	C:/Daten/Daten/All/Workspace/HCD/Model/pom.xml
ch.xmatrix.le.modelimpl	C:/Daten/Daten/All/Workspace/HCD/ModelImpl/pom.xml
ch.xmatrix.le.news	C:/Daten/Daten/All/Workspace/HCD/News/pom.xml
ch.xmatrix.le.project	C:/Daten/Daten/All/Workspace/HCD/pom.xml
maven-releasetree-plugin	C:/Daten/Daten/All/Workspace/Maven/maven-releasetree-plugin/pom.xml
ch.xmatrix.maven	C:/Daten/Daten/All/Workspace/Maven/pom.xml
ch.xmatrix.ups.pmb.common	C:/Daten/Daten/All/Workspace/PMB/Common/pom.xml
ch.xmatrix.ups.pmb.demo	C:/Daten/Daten/All/Workspace/PMB/Demo/pom.xml
ch.xmatrix.ups.pmb.input	C:/Daten/Daten/All/Workspace/PMB/Entry/pom.xml
ch.xmatrix.ups.pmb.exam	C:/Daten/Daten/All/Workspace/PMB/Exam/pom.xml
ch.xmatrix.pmb.pom	C:/Daten/Daten/All/Workspace/PMB/pom.xml
ch.xmatrix.ups.pmb.test	C:/Daten/Daten/All/Workspace/PMB/Test/pom.xml
ch.xmatrix	C:/Daten/Daten/All/Workspace/pom.xml
ch.xmatrix.le.application-test	C:/Daten/Daten/All/Workspace/Test/Application-Test/pom.xml
ch.xmatrix.test.helloworld	C:/Daten/Daten/All/Workspace/Test/HelloWorld/pom.xml
ch.xmatrix.test.jnlp	C:/Daten/Daten/All/Workspace/Test/JNLP/pom.xml
ch.xmatrix.test.osgi.consumer	C:/Daten/Daten/All/Workspace/Test/OSGiConsumer/pom.xml
ch.xmatrix.test.osgi.provider	C:/Daten/Daten/All/Workspace/Test/OSGiProvider/pom.xml
ch.xmatrix.test.pentaho	C:/Daten/Daten/All/Workspace/Test/Pentaho/pom.xml
ch.xmatrix.test	C:/Daten/Daten/All/Workspace/Test/pom.xml
ch.xmatrix.test.compile	C:/Daten/Daten/All/Workspace/Test/Test/pom.xml
ch.xmatrix.test.upload.client	C:/Daten/Daten/All/Workspace/Test/Upload/Client/pom.xml
ch.xmatrix.test.upload	C:/Daten/Daten/All/Workspace/Test/Upload/pom.xml
ch.xmatrix.test.upload.server	C:/Daten/Daten/All/Workspace/Test/Upload/Servlet/pom.xml
net.java.jveez	C:/Daten/Daten/All/Workspace/Third/JVeez/pom.xml
com.smardec.mousegestures	C:/Daten/Daten/All/Workspace/Third/MouseGestures/pom.xml
ch.xmatrix.third.pom	C:/Daten/Daten/All/Workspace/Third/pom.xml
ch.xmatrix.ups	C:/Daten/Daten/All/Workspace/UPS/pom.xml
ch.xmatrix.ups.tools.common	C:/Daten/Daten/All/Workspace/UPS/Tools/Common/pom.xml
ch.xmatrix.ups.tools.uec	C:/Daten/Daten/All/Workspace/UPS/Tools/ExamConfigurator/pom.xml
ch.xmatrix.ups.tools	C:/Daten/Daten/All/Workspace/UPS/Tools/pom.xml
ch.xmatrix.ups.tools.ust	C:/Daten/Daten/All/Workspace/UPS/Tools/StudentTool/pom.xml
